1111111111111111111111111111111111111111111111111111
1000000000000011111111111111111111111111111111111111
1111111111100P00000111111111111111111111111111111111
11111111111100000C0001111111111111111111111111111111
1111111111110000000001111111111111111111111111111111
1111111111111111111100000000111111111111111111111111
1111111111111111111111101111111111111111111111111111
1111111111111111111100000000111111111111111111111111
1111111111111111111100000000111111111111111111111111
111111111111111111110000000E111111111111111111111111
1111111111111111111111111111111111111111111111111111
1111111111111111111111111111111111111111111111111111
1111111111111111111111111111111111111111111111111111
1111111111111111111111111111111111111111111111111111
1111111111111111111111111111111111111111111111111111
1111111111111111111111111111111111111111111111111111