1111111111111111111111111111111111111111111111111111
1P00000000000011111111111111111111111111111111111111
1111111111100000000111111111111111111111111111111111
1111111111110000000011111111111111111111111111111111
1111111111110000000001111111111111111111111111111111
1111111111111111111100000000111111111111111111111111
111111111111111111111CCC0CCC111111111111111111111111
1111111111111111111100000000111111111111111111111111
1111111111111111111100000000111111111111111111111111
111111111111111111110000000E111111111111111111111111
1111111111111111111111111111111111111111111111111111
1111111111111111111111111111111111111111111111111111
1111111111111111111111111111111111111111111111111111
1111111111111111111111111111111111111111111111111111
1111111111111111111111111111111111111111111111111111
1111111111111111111111111111111111111111111111111111