111111111111
100000000111
100000000C11
1P00000001E1
111111111111