1111111111111
110000000C1
1001111101
1P0011E00001
1111111111111